W W W W W W W W W W W W W W W W W W W 
W - - - - - - W - - - - - - - - C - W
W - - E - H W - - - - - C - - - - - W
W - - - - - - H - H - - - - W - - - W
W - H - - - - H K H - - - - W - - - W
W - - - - C - - H - - - - - - - H C W
W - - - - - - - - - - - - - - W - - W
W - - C - - - - - - H - - - - W P - W
W - - - - - - - - - - - - - - - - - W
W W W W W W W W W W W W W W W W W W W