W W W W W W W W W W W W W W W W W W W 
W - - - - - - W - - - - - - - - P - W
W - - S - B W - - - - - B - - - - - W
W - - - - - - B W S - - - - - - - - W
W - S - - - - - - S - - - - S - - - W
W - - - - B - - S - - - - - - B - - W
W - - - - - - - - - - - - - - B - - W
W - - S - - - - - - H - - - - - B - W
W - - - - - - - - - - - - - - - - - W
W W W W W W W W W W W W W W W W W W W