W W W W W W W W W W W W W W W W W W W 
W - - - - - - W - - - - - - - - B - W
W - - P - B W - - - - - B - - - - - W
W - - - - - - S - - - - - - W - - - W
W - S - - - - - K - - - - - W - - - W
W - - - - B - - - - - - - - - - - - W
W - - - - - - - - - - - - - - - - - W
W - - B - - - - - - - S - - - - E - W
W - - - - - - - - - - - - - - - - - W
W W W W W W W W W W W W W W W W W W W