W W W W W W W W W W W W W W W W W W W 
W - - - - - - W - - - - - - - - C - W
W - - P - C W - - - - - C - - - - - W
W - - - - - - S - - - - - - W - - - W
W - S - - - - - K - - - - - W - - - W
W - - - - C - - - - - - - - - - - - W
W - - - - - - - - - - - - - - - - - W
W - - C - - - - - - - S - - - - E - W
W - - - - - - - - - - - - - - - - - W
W W W W W W W W W W W W W W W W W W W