W W W W W W W W W W W W W W W W W W W 
W - - - - - - W - - - - - - - - C - W
W - - P - C W - - - - - C - - - - - W
W - - - - - - H - H - - - - W - - - W
W - H - - - - H K H - - - - W - - - W
W - - - - C - - H - - - - - - - - - W
W - - - - - - - - - - - - - - - - - W
W - - C - - - - - - - H - - - - E - W
W - - - - - - - - - - - - - - - - - W
W W W W W W W W W W W W W W W W W W W