W W W W W W W W W W W W W W W W W W W 
W - - - - - - W - - - - - - - - C - W
W - - E - H W - - - - - C - - - - - W
W - - - - - - H - H - - - - W - - - W
W - H - - - - B - H - - - - W - - - W
W - - - - C - - H - - - - - - - H C W
W - - - - - - - - - - - - - - S - - W
W - - C - - - - - - H - - - - W P - W
W - - - - - - - - - - - - - - - - - W
W W W W W W W W W W W W W W W W W W W